かごたどうし	か五他動詞	か行五段
かごどうし	か五動詞	か行五段
かんとうし	間投詞	感動詞
がいしゃめい	会社名	固有名詞
がごたどうし	が五他動詞	が行五段
がごどうし	が五動詞	が行五段
けいようし	形容詞	形容詞
さごたどうし	さ五他動詞	さ行五段
さごどうし	さ五動詞	さ行五段
じんめい	人名	姓
すうじ	数字	顔文字
するふくし	する副詞	副詞
するめいし	する名詞	さ変名詞
たごたどうし	た五他動詞	た行五段
たごどうし	た五動詞	た行五段
たんかんじ	単漢字	単漢字
ちめい	地名	地名その他
てんせんと	テンセント	短縮よみ
とするふくし	とする副詞	副詞
とたるふくし	とたる副詞	形容動詞
とふくし	と副詞	副詞
なごたどうし	な五他動詞	な行五段
なごどうし	な五動詞	な行五段
なさするめいし	なさする名詞	名詞
なさめいし	なさ名詞	名詞
なするめいし	なする名詞	名詞
なめいし	な名詞	形動名詞
ばごたどうし	ば五他動詞	ば行五段
ばごどうし	ば五動詞	ば行五段
ふかし	付加詞	名詞
ふつうふくし	普通副詞	副詞
まごたどうし	ま五他動詞	ま行五段
まごどうし	ま五動詞	ま行五段
らごたどうし	ら五他動詞	ら行五段
らごどうし	わ五動詞	あわ行五段
らごどうし	ら五動詞	ら行五段
わとたどうし	わ五他動詞	あわ行五段
